┌────────────────────────┬                
│E                       │                
├───┐         ┌─┬────┐   │     ┌────┐      
    └──┐      └─┤    │   │   ┌─┘    │      
       └┐       │    │   │   │      └─┐    
        └┐      │   ┌┘   │  ┌┘   ┌─   │    
         │ ┌────┘   │    │  │    │^   │    
         └─┘     ┌──┘    │  │    │^   └┐   
               ┌─┘    ┌──┘ ┌┘    │^   ^│   
           ┌───┘   ┌──┘    │     │^   ^│   
           │     ┌─┘   ┌───┘    ┌┘^   ^│   
      ┌────┘  ^ ┌┘     │        │^    ^│   
      │      ┌──┘    ┌─┘    ┌───┤^    ^│   
      │ ^^^# │    ┌──┘   ┌──┘   │^    ^│   
   ┌──┘  ────┴────┘     ┌┘      │^    ^│   
   │                ┌───┘ ┌─────┘^    ^│   
   └────────────────┘     │X          ^│   
                          └────────────┘   
                                          
                                           