┌──────────────────┬                     
│E                 │                     
│       ┌───────┐  └┐                    
├──────┬┘       │   └─┐      ┌────────┐  
       │        └┐    └─┐    │#    ^^^│  
       │        #├─┐    └┐   └─┐^    ^│  
     ┌─┘         ┤ └┐^   └─┐   └┐^   ^│  
     │     ┌──┐  └┐ └─┐    └─┐  └─┐  ^│  
     │    ┌┘X └┐  └┐  ├─┐^   └┐   │  ^│  
     └─┐  │    │   └──┤ ├─┐   └┐  │  ^│  
       │  └┐   └─┐    └─┤ └┐^  └┐ │ ^ │  
       └┐  └┐    └┐     │  └─┐  │ │  ┌┘  
        │   └┐   ^│    ┌┴─   │  │ │  │   
        └┐   └┐^  └─┐  │    ┌┘  │ │  │   
         │    └┐    │  └─┐ ┌┘   │ │  │   
         │^    │^   │    └─┘    │ │  │   
         └──┐       └──┐        └─┘  │   
            └─┐        │            ┌┘   
              │        ├────────────┤    
              ┴────────┴                  