┌────────┬───────────────────────────┬────────┬────┐
│E       │      ^                    │^^^  ^^^│    │
│               │             │       ^ ^^│ ^^^^  ┌┤
├───────────────┴────   ──────┼───────────┼───────┼│
│                          ^  ├────┼───────────┼───┤
│     ┌──     ^               │    │           │   │
│     │     ──┐     ─┬────────┤    │           │   │
│     │       ├──┐ ^ │        │    ├───────┐   │   │
│  │  │       │  │   │        │    │       │   │   │
│  └─┬┴───────┤  │   │             │           │   │
│ ^  │        │      │       ───┬──┘    │          │
│    │     ^  │      │          │       └──────────┤
│    │        │      │         ─┘   │              │
│    │    │   │      │   │     ^    │   ───┐       │
│    │    └───┴──────┤   └──┬───────┼─     │   ────┤
│    │               │      │       │      │       │
│    │  ───┐  ───────┘      │       │   ┌──┤  ┌──  │
│  │ │     │                │       │   │  │  │    │
│^ └─┤     │ ^              └─      │      │ X│    │
│    │     │      │  ───┐           │     ─┴──┴─┐  │
│    ├─────┴─────┬┘     │         │ │           │  │
│    │           │      ├─────────┘ │     ┌──  ┌┴──┤
│    │    ^      │      │   ^          ^  │    │   │
│    └───     ───┘      │                 │    │   │
│                       │          │      │        │
└───────────────────────┴──────────┴──────┴────────┘