┌──┬     ┬─────────────────────────┬       
│E │     │                         │       
│  └─┐   └─┐    ┌┬───┐             │       
│    └─┐   │    └┤   └┐        ┌─┐#│       
│     ^└─┐ │     └─┐  └─┐      │ └─┘       
│       ^│ └─┐     └┐   └┐     │           
│       ^└┐  └──┐   └┐   └┐    └─┐         
│        ^└─┐   │    │    │    ^^│         
│     ^^^^^^└─┐ │    │    │    ┌─┤         
│     ┌───┐^^^│ │    │   ┌┘    └─┤         
│     │   └───┘ │    │   │     ^^│         
│     └┐        │    │  ┌┘    ^┌─┘         
│      └────────┘    │  │     ┌┘           
│                    │  │    ^│            
├────────────────────┘  └┐  ┌─┘            
                         │  │              
                   ┌─────┘  │              
                ┌──┘        │              
                │X    ┌─────┤              
                ┴─────┴─────┴               