┌───┬───────────────────────────────────┐
│E  │           ^          ^            │
│   │     ^                         ^   │
│^ ^│   ┌───────────────────────────┐   │
│   │ ^ │                           │  ^│
│   │   │   ┌───────────────────┐   │   │
│ ^ │ ^ │   │                   │   │   │
│   │   │   │                   │^  │   │
│   │   │   │  ┌───────┬────┐   │   │   │
│^ ^│  ^│   │  └───────┘## X│   │  ^│ ^ │
│   │   │   │               │   │   │   │
│   │   │   └───────────────┘   │   │   │
│ ^ │^  │                       │   │   │
│   │   └───────────────────────┘   │   │
│   │         ^               ^   ^ │^  │
│^ ^│  ^                 ^          │   │
│   └───────────────────────────────┘  ^│
│       ^            ^           ^      │
│ ^            ^            ^         ^ │
└───────────────────────────────────────┘