┌────────────────────────┬               
│E                       │               
├─────────────────┐      │               
                  │^    ^│               
                 ┌┘      │               
                ┌┘       └┐              
               ┌┘         └┐             
             ┌─┘           │             
           ┌─┘             └┬┐           
           │                └┤           
         ┌─┘                #│           
         │                   └┐          
       ┌─┘                    │          
       │ ^   ^   ^       ┌────┤          
      ┌┘                 │^   │          
      │^  ^  ^  ^        │X │ │          
    ┌─┘                  └──┘ │          
  ┌─┘                         │          
  │^ ^ ^#^ ^ ^ ^ ^ ^ ^ ^ ^ ^ ^│          
  ┴───────────────────────────┴           