┌──────────────────┬             ┬─────┐
│E                 │             │^^^^^│
├──┬────┐          └─────────────┤^   ^│
   │^^^^└───┐                    │^   ^│
  │         └──┐             ┌─┐      ^│
  │  ─────┐    └──┐          │ ├┬───  ^│
  │       └┐      └──┐       └─┴┤^    ^│
  │        └─┐^^^^   └──┐       │^    ^│
  │  ┌─┐^    └────┐^    └─┐     └─┐   ^│
  │  │ └──┐       └─┐     └─┐     │#^^^│
  │  └─┐  └┐^^      │^^     └─┐   └────┤
  │    └─┐ ├┬────┐  └────┐^^  └─┐     ┌┘
  │      └─┴┤    │^      └──┐   └─┐   │ 
  │   ┌┐    └─┐  ├┬──┐     #│     │   │ 
  │   ├┴──┐   └──┴┤  ├┬─────┘     │   │ 
  │   │   └┐      └──┴┤X        ┌─┘   │ 
  │   └──┐ ├──┐       └────┐   ┌┘   ┌─┘ 
  │ ^^^  └─┘^^└────┐       └───┘    │   
  │               #│                │   
 ─┴────────────────┴────────────────┴    