┌─────────────────────────┬────┬───────┬   
│E                        │    │X      │   
├─┐^                      └──┐ └───┐   └──┤
  └┐^                        └┐    └┐     │
   └┐^                        └─┐   └─┐   │
    └┐^                         └┐    │   │
     └┐^                         └────┘   │
      └┐^                                 │
       │^         ^^^^^^^^^       ^^^^^^  │
      ┌┘^      ^^┌────────┐^     ^┌───────┤
     ┌┘^      ^┌─┘        │^   ^^┌┘        
    ┌┘^      ^┌┘        ┌─┘^  ^┌─┘         
   ┌┘^      ^┌┘        ┌┘^^  ^┌┘           
  ┌┘^      ^┌┘        ┌┘^   ^┌┘            
├─┘^      ^┌┘        ┌┘^   ^┌┘             
│^^      ^┌┘        ┌┘^  ^^┌┘              
├─┐^  # ^┌┘        ┌┘^# ^┌─┘               
  └─┐   ┌┘       ┌─┘^  ^┌┘                 
    │^^^│        │^^^^^^│                  
    ┴───┴        ┴──────┴                   