┌──┬                                     
│E │                                     
│  │                                     
│  │                                     
│  │     ┌────────────┐                  
│  │     │            │                  
│  └┐    └┐   ─┐      │                  
│   │     │    │ ^ ^ ^│                  
│   └─┐   └┐   └┐   ┌─┘                  
│     │    │   ^│   │                    
│     └┐   └┐  ^│   │                    
│      │    │  ^│  ┌┤                    
├─┐    └─┐ ┌┘ ┌─┘  └┴───┬───────┐        
  │      │ │  │        #│       └─┐      
  └──┐   └─┘  │   ┌─────┘   ┌─┐   └┐     
     │        │ ^ │#^^^     │ │    └──┐  
     └──────┬─┘   └──── ┌───┘ └┐^^    │  
            │           │      └──┐   │  
            │ ^ ^ ^ ^ ^ │         │ X │  
            ┴───────────┴         ┴───┴   